0 0 0 0 0 0 0 0 0 0 0 0 0 0 0 0 0 0 0 0 0 0 0 0 0 0 0 0 0 0 0 0 0 0 0 0 0 0 0 0 0 0 0 0 0 0 0
0 0 0 0 0 0 0 10 12 12 2 2 12 12 12 12 2 6 0 9 6 0 0 0 0 0 0 0 0 0 0 0 0 0 0 0 0 0 0 0 0 0 0 0 0 0 0
0 0 0 0 0 0 0 0 0 0 5 3 0 0 0 0 5 1 12 4 7 0 0 0 0 0 0 0 0 1 6 0 0 0 0 0 0 0 0 0 0 0 0 0 0 0 0
0 0 0 0 0 0 0 0 0 0 5 3 0 0 0 0 5 3 0 0 0 0 0 0 0 0 0 0 0 0 8 2 6 0 0 0 0 0 0 0 0 0 0 0 0 0 0
0 0 0 0 0 0 0 9 2 2 1 1 2 2 2 6 5 3 0 0 0 0 0 0 0 0 0 0 0 0 0 5 7 0 9 2 2 6 0 0 0 0 0 0 0 0 0
0 0 0 0 0 0 0 8 4 4 1 1 4 4 4 7 5 1 2 2 6 0 0 0 0 0 0 0 0 0 0 12 0 0 5 1 1 3 0 0 0 0 0 0 0 0 0
0 0 0 0 0 0 0 0 0 0 5 3 0 0 0 0 5 1 4 4 7 0 9 2 2 2 2 2 2 2 2 1 2 2 2 1 1 1 2 2 2 2 6 0 14 0 0
0 0 0 0 0 0 0 0 0 0 5 3 0 0 0 0 5 3 0 0 0 0 5 1 1 4 4 1 4 4 4 4 4 4 4 4 1 7 4 4 4 1 4 12 7 0 0
0 0 0 0 0 0 0 9 2 2 1 1 2 2 1 6 5 3 0 0 0 0 5 1 3 9 2 1 6 14 0 0 14 0 0 9 1 6 0 0 0 13 0 0 0 0 0 
0 0 0 0 0 0 0 8 4 4 4 4 1 7 0 15 8 1 12 12 12 9 1 1 3 5 1 1 3 13 0 0 13 0 0 5 1 3 10 12 12 1 12 12 11 0 0
0 9 2 2 2 2 2 2 2 2 2 2 1 2 2 2 2 1 2 2 2 4 1 1 3 8 4 4 7 13 0 0 13 0 0 5 1 3 0 0 0 13 0 0 0 0 0
0 8 4 4 4 4 4 1 4 4 4 4 4 4 4 4 1 4 4 4 4 7 0 5 7 0 0 0 0 5 12 12 4 12 2 1 1 3 10 12 12 1 12 12 11 0 0 
0 0 0 0 13 0 9 1 2 2 2 6 9 6 0 9 1 2 12 12 6 9 2 1 6 0 0 0 0 13 0 0 0 0 13 0 0 13 0 0 0 13 0 0 0 0 0
0 0 0 0 5 2 1 1 4 4 4 7 8 4 12 4 1 3 0 0 13 8 4 1 3 0 9 2 6 13 0 0 0 0 13 0 0 13 10 12 12 1 12 12 11 0 0
0 0 0 0 5 1 1 3 0 0 0 0 0 0 0 0 5 3 0 0 13 0 0 5 1 2 1 4 4 1 2 2 12 2 3 0 0 13 0 0 0 13 0 0 0 0 0
0 0 0 0 5 1 1 3 0 0 0 0 0 0 0 0 5 3 0 0 13 10 12 4 4 4 7 0 0 8 4 7 0 8 7 0 0 8 12 12 12 4 12 12 11 0 0 
0 0 0 0 5 1 1 1 2 2 2 6 9 2 2 2 1 3 0 0 13 0 0 0 0 0 0 0 0 0 0 0 0 0 0 0 0 0 0 0 0 0 0 0 0 0 0
0 0 0 0 5 1 1 1 4 4 4 7 8 4 4 4 1 3 0 0 13 0 0 0 0 0 0 0 0 0 0 0 0 0 0 0 0 0 0 0 0 0 0 0 0 0 0 
0 0 0 0 5 1 1 3 0 0 0 0 0 0 0 0 5 3 0 0 13 0 0 0 0 0 0 0 0 0 0 0 0 0 0 0 0 0 0 0 0 0 0 0 0 0 0 
0 0 0 0 8 1 1 3 0 0 0 0 0 0 0 0 5 3 0 0 13 0 0 0 0 0 0 0 0 0 0 0 0 0 0 0 0 0 0 0 0 0 0 0 0 0 0
0 0 0 0 0 8 4 4 12 12 12 12 12 12 12 12 4 4 1 1 7 0 0 0 0 0 0 0 0 0 0 0 0 0 0 0 0 0 0 0 0 0 0 0 0 0 0 
0 0 0 0 0 0 0 0 0 0 0 0 0 0 0 0 0 0 0 0 0 0 0 0 0 0 0 0 0 0 0 0 0 0 0 0 0 0 0 0 0 0 0 0 0 0 0